
C ,,9

R 1940 		434



F 255,255,25


WE ./gnl/get_next_line.c
EA ./gnl/get_next_line_utils.c
S		./utils/ft_strncmp.c
S

NO	./utils/ft_strtol.c
SO map_parser.c


1111111111111111111111111 111
11222222211122222 2222111 111 
    12211W0011
1111111111101111  11
1111 111  101     
111       101
1111111111101
111111111111