
C ,245,

R 2000 		1200



F 127,111,27


WE ./textures/ryan.xpm
EA ./textures/ryan.xpm
S		./textures/ryan.xpm

NO	./textures/ryan.xpm
SO ./textures/ryan.xpm

    
 11111111111111
1S0000000000001
10111111111111
10000000000001
10000000000001
10000000000001
10000000000001
10000011100001
11110000000111
1111111111111