
C ,,9

R 1940 		434



F 255,255,25


WE ./gnl/get_next_line.c
EA ./gnl/get_next_line_utils.c
S		./utils/ft_strncmp.c
S

NO	./utils/ft_strtol.c
SO map_parser.c



112222222111222222222111111
    12211W0011
111111111011111111
1111111111111