
C ,,9

R 2000 		1200



F 255,255,25


WE ./gnl/get_next_line.c
EA ./gnl/get_next_line_utils.c
S		./utils/ft_strncmp.c
S

NO	./utils/ft_strtol.c
SO map_parser.c

       11111101
       1110001
1111111111101111111111111 111
111111111110111111112111 111 
111110000000000000001
1000000100000000000011111110
100000000000010000000000001
1000000100S00000000001111111
100000111010100000000000001
100000010000001000000000001
111111101111111111111111110
1111000000101     
11100000000101
1111111110101
111111111011
        111