
C ,245,

R 1200		800



F 127,111,28


WE ./textures/ryan.xpm
EA ./textures/mossy.xpm
S	./textures/barrel.xpm

NO	./textures/eagle.xpm
SO ./textures/bluestone.xpm

111111111111111
100000000000001
100000000000001
100000000000001
100000121000021
100000000000001
100000000000001
1000000N0000001
111111111111111