
C ,245,

R 2000		1200



F 127,111,27


WE ./textures/ryan.xpm
EA ./textures/mossy.xpm
S	./textures/ryan.xpm

NO	./textures/eagle.xpm
SO ./textures/bluestone.xpm

111111111111111
100000000000001
100000000000001
100000000000001
100000020000001
100000000000001
100000000000001
1000000000000S1
1011111111111111111111111111111111111111111
1002000000020212222222222222222222222222221
1000000000000222222222222222222222222222221
1000020200000122222222222222222222222222221
1000000000000222222222222222222222222222221
1000000000000222222222222222222222222222221
1000000000000000000000000000000000000000001
1000000000000222222222222222222222222222221
1000000000000222222222222222222222222222221
1000000000000222222222222222222222222222221
1000000000000222222222222222222222222222221
1000000000000222222222222222222222222222221
1000000000000222222222222222222222222222221
1000000000000222222222222222222222222222221
1111222222211111111111111111111111111111111
1111111111111