
C 255,255,255

R 1270 720



F 127,  111 , 255


WE ./textures/wood.xpm
EA ./textures/mossy.xpm
S	./textures/barrel.xpm

NO	./textures/eagle.xpm
SO ./textures/bluestone.xpm

111111111111111
100000000000001
100000000000001
100000000000001
100000121000021
100000000000001
100000000000001
1000000N0000001
111111111111111