
C ,245,

R 1000		800



F 127,111,28


WE ./textures/ryan.xpm
EA ./textures/mossy.xpm
S	./textures/barrel.xpm

NO	./textures/eagle.xpm
SO ./textures/bluestone.xpm

111111111111111
100000000000001
100000000000001
100000000000001
100000020000001
100000000000001
100000000000001
1000000000000S1
111111111111111