
C 255,255,255

R 4000	4000



F 127,  111 , 255


WE ./textures/wood.xpm
EA ./textures/mossy.xpm
S	./textures/ryan.xpm

NO	./textures/eagle.xpm
SO ./textures/bluestone.xpm

111111111111111
100000000000001
100000000000001
100000020000001
100000020000001
100000020000001
100000020000001
100000000000001
111111000111111
111111000111111
1111110N0111111
111111111111111